▓▓▓▓▓▓▓▓▓▓▓▓▓▓▓▓▓▓▓▓▓▓▓▓▓▓▓▓▓▓▓▓▓▓▓▓▓▓▓▓▓▓▓▓▓▓▓▓▓▓▓▓
▓▓▓▓▓▓▓▓▓▓▓▓▓▓▓▓▓▓▓▓▓▓▓▓▓▓▓▓▓▓▓▓▓▓▓▓▓▓▓▓▓▓▓▓▓▓▓▓▓▓▓▓
▓▓▓▓    ████                            ▓▓▓▓    ▓▓▓▓
▓▓▓▓    ████                            ▓▓▓▓    ▓▓▓▓
▓▓▓▓    ▓▓▓▓    ▓▓▓▓████        ▓▓▓▓    ▓▓▓▓    ▓▓▓▓
▓▓▓▓    ▓▓▓▓    ▓▓▓▓████        ▓▓▓▓    ▓▓▓▓    ▓▓▓▓
▓▓▓▓            ▓▓▓▓                ▓▓▓▓        ▓▓▓▓
▓▓▓▓            ▓▓▓▓                ▓▓▓▓        ▓▓▓▓
▓▓▓▓    ▓▓▓▓▓▓▓▓████    ████████████▓▓▓▓▓▓▓▓    ▓▓▓▓
▓▓▓▓    ▓▓▓▓▓▓▓▓████    ████████████▓▓▓▓▓▓▓▓    ▓▓▓▓
▓▓▓▓            ▓▓▓▓            ▓▓▓▓    ▓▓▓▓    ▓▓▓▓
▓▓▓▓            ▓▓▓▓            ▓▓▓▓    ▓▓▓▓    ▓▓▓▓
▓▓▓▓    ▓▓▓▓    ▓▓▓▓████████            ▓▓▓▓    ▓▓▓▓
▓▓▓▓    ▓▓▓▓    ▓▓▓▓████████            ▓▓▓▓    ▓▓▓▓
▓▓▓▓    ████                    ▓▓▓▓            ▓▓▓▓
▓▓▓▓    ████                    ▓▓▓▓            ▓▓▓▓
▓▓▓▓    ▓▓▓▓    ▓▓▓▓    ▓▓▓▓    ▓▓▓▓▓▓▓▓        ▓▓▓▓
▓▓▓▓    ▓▓▓▓    ▓▓▓▓    ▓▓▓▓    ▓▓▓▓▓▓▓▓        ▓▓▓▓
▓▓▓▓            ▓▓▓▓                            ▓▓▓▓
▓▓▓▓            ▓▓▓▓                            ▓▓▓▓
▓▓▓▓    ▓▓▓▓████▓▓▓▓▓▓▓▓▓▓▓▓▓▓▓▓▓▓▓▓▓▓▓▓▓▓▓▓    ▓▓▓▓
▓▓▓▓    ▓▓▓▓████▓▓▓▓▓▓▓▓▓▓▓▓▓▓▓▓▓▓▓▓▓▓▓▓▓▓▓▓    ▓▓▓▓
▓▓▓▓                    ████                    ▓▓▓▓
▓▓▓▓                    ████                    ▓▓▓▓
▓▓▓▓▓▓▓▓▓▓▓▓▓▓▓▓▓▓▓▓▓▓▓▓▓▓▓▓▓▓▓▓▓▓▓▓▓▓▓▓▓▓▓▓▓▓▓▓▓▓▓▓
▓▓▓▓▓▓▓▓▓▓▓▓▓▓▓▓▓▓▓▓▓▓▓▓▓▓▓▓▓▓▓▓▓▓▓▓▓▓▓▓▓▓▓▓▓▓▓▓▓▓▓▓
