▓▓▓▓▓▓▓▓▓▓▓▓▓▓▓▓▓▓▓▓▓▓▓▓▓▓▓▓▓▓▓▓▓▓▓▓▓▓▓▓▓▓▓▓▓▓▓▓▓▓▓▓
▓▓▓▓▓▓▓▓▓▓▓▓▓▓▓▓▓▓▓▓▓▓▓▓▓▓▓▓▓▓▓▓▓▓▓▓▓▓▓▓▓▓▓▓▓▓▓▓▓▓▓▓
▓▓▓▓    ▓▓▓▓                            ▓▓▓▓    ▓▓▓▓
▓▓▓▓    ▓▓▓▓                            ▓▓▓▓    ▓▓▓▓
▓▓▓▓    ▓▓▓▓    ▓▓▓▓▓▓▓▓████    ▓▓▓▓    ▓▓▓▓    ▓▓▓▓
▓▓▓▓    ▓▓▓▓    ▓▓▓▓▓▓▓▓████    ▓▓▓▓    ▓▓▓▓    ▓▓▓▓
▓▓▓▓                            ▓▓▓▓            ▓▓▓▓
▓▓▓▓                            ▓▓▓▓            ▓▓▓▓
▓▓▓▓▓▓▓▓    ▓▓▓▓████    ████████████▓▓▓▓▓▓▓▓    ▓▓▓▓
▓▓▓▓▓▓▓▓    ▓▓▓▓████    ████████████▓▓▓▓▓▓▓▓    ▓▓▓▓
▓▓▓▓            ▓▓▓▓            ▓▓▓▓    ▓▓▓▓    ▓▓▓▓
▓▓▓▓            ▓▓▓▓            ▓▓▓▓    ▓▓▓▓    ▓▓▓▓
▓▓▓▓    ▓▓▓▓    ▓▓▓▓▓▓▓▓████    ▓▓▓▓    ▓▓▓▓    ▓▓▓▓
▓▓▓▓    ▓▓▓▓    ▓▓▓▓▓▓▓▓████    ▓▓▓▓    ▓▓▓▓    ▓▓▓▓
▓▓▓▓    ▓▓▓▓                    ▓▓▓▓            ▓▓▓▓
▓▓▓▓    ▓▓▓▓                    ▓▓▓▓            ▓▓▓▓
▓▓▓▓    ▓▓▓▓    ▓▓▓▓▓▓▓▓████    ▓▓▓▓▓▓▓▓▓▓▓▓████▓▓▓▓
▓▓▓▓    ▓▓▓▓    ▓▓▓▓▓▓▓▓████    ▓▓▓▓▓▓▓▓▓▓▓▓████▓▓▓▓
▓▓▓▓    ▓▓▓▓                                    ▓▓▓▓
▓▓▓▓    ▓▓▓▓                                    ▓▓▓▓
▓▓▓▓    ▓▓▓▓▓▓▓▓▓▓▓▓    ▓▓▓▓▓▓▓▓▓▓▓▓▓▓▓▓▓▓▓▓    ▓▓▓▓
▓▓▓▓    ▓▓▓▓▓▓▓▓▓▓▓▓    ▓▓▓▓▓▓▓▓▓▓▓▓▓▓▓▓▓▓▓▓    ▓▓▓▓
▓▓▓▓                    ▓▓▓▓                    ▓▓▓▓
▓▓▓▓                    ▓▓▓▓                    ▓▓▓▓
▓▓▓▓▓▓▓▓▓▓▓▓▓▓▓▓▓▓▓▓▓▓▓▓▓▓▓▓▓▓▓▓▓▓▓▓▓▓▓▓▓▓▓▓▓▓▓▓▓▓▓▓
▓▓▓▓▓▓▓▓▓▓▓▓▓▓▓▓▓▓▓▓▓▓▓▓▓▓▓▓▓▓▓▓▓▓▓▓▓▓▓▓▓▓▓▓▓▓▓▓▓▓▓▓
