▓▓▓▓▓▓▓▓▓▓▓▓▓▓▓▓▓▓▓▓▓▓▓▓▓▓▓▓▓▓▓▓▓▓▓▓▓▓▓▓▓▓▓▓▓▓▓▓▓▓▓▓
▓▓▓▓▓▓▓▓▓▓▓▓▓▓▓▓▓▓▓▓▓▓▓▓▓▓▓▓▓▓▓▓▓▓▓▓▓▓▓▓▓▓▓▓▓▓▓▓▓▓▓▓
▓▓▓▓    ▓▓▓▓                                    ▓▓▓▓
▓▓▓▓    ▓▓▓▓                                    ▓▓▓▓
▓▓▓▓    ▓▓▓▓▓▓▓▓▓▓▓▓    ▓▓▓▓▓▓▓▓▓▓▓▓▓▓▓▓▓▓▓▓    ▓▓▓▓
▓▓▓▓    ▓▓▓▓▓▓▓▓▓▓▓▓    ▓▓▓▓▓▓▓▓▓▓▓▓▓▓▓▓▓▓▓▓    ▓▓▓▓
▓▓▓▓                    ▓▓▓▓                    ▓▓▓▓
▓▓▓▓                    ▓▓▓▓                    ▓▓▓▓
▓▓▓▓▓▓▓▓▓▓▓▓████████    ████████████▓▓▓▓▓▓▓▓    ▓▓▓▓
▓▓▓▓▓▓▓▓▓▓▓▓████████    ████████████▓▓▓▓▓▓▓▓    ▓▓▓▓
▓▓▓▓            ▓▓▓▓                    ▓▓▓▓    ▓▓▓▓
▓▓▓▓            ▓▓▓▓                    ▓▓▓▓    ▓▓▓▓
▓▓▓▓    ▓▓▓▓    ▓▓▓▓    ████▓▓▓▓▓▓▓▓    ▓▓▓▓    ▓▓▓▓
▓▓▓▓    ▓▓▓▓    ▓▓▓▓    ████▓▓▓▓▓▓▓▓    ▓▓▓▓    ▓▓▓▓
▓▓▓▓    ▓▓▓▓                    ████            ▓▓▓▓
▓▓▓▓    ▓▓▓▓                    ████            ▓▓▓▓
▓▓▓▓    ▓▓▓▓    ▓▓▓▓▓▓▓▓▓▓▓▓████▓▓▓▓▓▓▓▓    ▓▓▓▓▓▓▓▓
▓▓▓▓    ▓▓▓▓    ▓▓▓▓▓▓▓▓▓▓▓▓████▓▓▓▓▓▓▓▓    ▓▓▓▓▓▓▓▓
▓▓▓▓    ▓▓▓▓    ████                            ▓▓▓▓
▓▓▓▓    ▓▓▓▓    ████                            ▓▓▓▓
▓▓▓▓            ▓▓▓▓    ▓▓▓▓████▓▓▓▓▓▓▓▓▓▓▓▓    ▓▓▓▓
▓▓▓▓            ▓▓▓▓    ▓▓▓▓████▓▓▓▓▓▓▓▓▓▓▓▓    ▓▓▓▓
▓▓▓▓    ▓▓▓▓                            ▓▓▓▓    ▓▓▓▓
▓▓▓▓    ▓▓▓▓                            ▓▓▓▓    ▓▓▓▓
▓▓▓▓▓▓▓▓▓▓▓▓▓▓▓▓▓▓▓▓▓▓▓▓▓▓▓▓▓▓▓▓▓▓▓▓▓▓▓▓▓▓▓▓▓▓▓▓▓▓▓▓
▓▓▓▓▓▓▓▓▓▓▓▓▓▓▓▓▓▓▓▓▓▓▓▓▓▓▓▓▓▓▓▓▓▓▓▓▓▓▓▓▓▓▓▓▓▓▓▓▓▓▓▓
